学校  :  がっこう  :  HỌC HIỆU
小学校 : しょうがっこう  :  tiểu học hiệu
中学校  :  ちょうがっこう  :  trung học hiệu
高校  :  こうこう  :  cao hiệu
大学  :  だいがく  :  đại học
大使館  :  たいしかん  :  đại sử quán
水族館  :  すいぞくかん  :  thủy tộc quán
図書館  :  としょかｎ  :  đồ thư quán
図書室  :  としょしつ  :  đồ thư thất
事務室  :  じむしつ  :  thư vụ thất
教室  :  きょうしつ  :  giáo thất
教会  :  きょうかい  :  giáo hội
公園  :  こうえん  :  công viên
動物園  :  どうぶつえん  :  động vật viên
会社  :  かいしゃ  :  hội xã
銀行 : ぎんこう  :  ngân hành
空港 : くうこう  :  không cảng
病院  :  びょういん  :  bệnh viện
都市  :  とし  :  đô thị
食堂  :  しょくどう  :  thực đường
実家  :  じっか  :  thực gia
家族 : かぞく  :  gia tộc
兄弟 : きょうだい  :  huynh đệ
ご主人 : ごしゅじん  :  chủ nhân
自分で : じぶんで  :  tự phân
散歩 : さんぽ  :  tản bộ
試合 : しあい  :  thí hợp
病気 : びょうき  :  bệnh khí
天気 : てんき  :  thiên khí
台風 : たいふう  :  đài phong
料理 : りょうり  :  liệu lý
あの方  :  あのかた  :  phương
あの人  :  あのひと  :  nhân
男の人  :  おとこのひと  :  nam nhân
女の人  :  おんなのひと  :  nữ nhân
男の子  :  おとこのこ  :  nam tử
女の子 : おんなのこ  :  nữ tử
子ども : こども  :  tử
皆さん  :  みなさん  :  giai
私 : わたし  :  tư
山 : やま  :  sơn
海 : うみ  :  hải
川  :  かわ  :  xuyên
水  :  みず  :  thủy
桜 : さくら  :  anh
花 : はな  :  hoa
国 : くに  :  quốc
町 : まち :  đinh
店 : みせ : điếm
駅 : えき : dịch
家 : いえ : gia
物 : もの : vật
車 : くるま : xa
絵 : え : hội
色 : いろ : sắc
市場  : いちば : thị trường
売り場 : うりば :  mại trường
部屋 : へや : bộ ốc
花屋  : はなや : hoa ốc
本屋  : ほんや :  bản ốc
お寺 : おてら : tự
お手洗い : おてあらい : thủ tẩy
お金 : おかね : kim
手紙 : てがみ : thủ chỉ
切手 : きって : thiết thư
食べ物 : たべもの : thực vật
飲み物 : のみもの : ẩm vật
果物 : くだもの : quả vật
犬 : いぬ : khuyển
鳥 : とり : điểu
父 : ちち : phụ
母 : はは : mẫu
兄 : あに : huynh
姉 : あね : tỷ
弟 : おとうと : đệ
妹 : いもうと : muội
頭 : あたま : đầu
顔 : かお : nhan
手 : て : thủ
口 : くち : khẩu
耳 : みみ : nhĩ
目 : め : mục
夫 : おっと : phu
妻 : つま : thê
雨 : あめ : vũ
風 : かぜ : phong
春 : はる : xuân
夏 : なつ : hạ
秋 : あき : thu
冬 : ふゆ : đông
春休み : はるやすみ : xuân hưu
夏休み : なつやすみ : hạ hưu
冬休み : ふゆやすみ : đông hưu
一人で : ひとりで : nhất nhân
早く : はやく : tảo(sớm)