洗います : あらいます : tẩy
買います : かいます : mãi
会います : あいます : hội
書きます : かきます : thư
聞きます : ききます : văn
行きます : いきます : hành
働きます : はたらきます : động
話します : はなします : thoại
飲みます : のみます : ẩm
読みます : よみます : độc
休みます : やすみます : hưu
帰ります : かえります : quy
戻りま : もどります : lệ
作ります : つくります : tác
切ります : きります : thiết
始まります : はじまります : thủy
終わります : おわります : chung
分かります : わかります : phân
食べます : たべます : thực
寝ます : ねます : tẩm
起きます : おきます : khởi
見ます : みます : kiến
来ます : きます : lai
勉強します : べんきょうします : miễn cường
散歩します : さんぽします : tản bộ
食事します : しょくじします : thực sự
旅行します : りょこうします : lữ hành
見学します : けんがくします : kiến học
昼寝をします : ひるねをします : trú tẩm
買い物します : かいものします : mãi vật